30
30
PPPPPPPPPPPPPPPPPPPPPPPPPPPPPP
PPPPPPPPPPPPPPPPPPPPPPPPPPPPPP
PPPPPPPPPPPPPPPPPPPPPPPPPPPPPP
PPPSSSCSSCCCSSSCSSSSCSSSSSSPPP
PPPSCSCCCCSCCCCCSSCCCCCSSSSPPP
PPPSCCCSSSSCSSCCCCCSSSCCCSSPPP
PPPSCSBBBBBBBBBBBBBBBBBBCCSPPP
PPPCCCBBBBBBSSSBBBBBSBBBSCCPPP
PPPCXCBBBBSCSSCSSCSSSSBBSXCPPP
PPPCSCBBBSCCCCCCCCBSSSBBSCCPPP
PPPCCCBBBCCXSCBBSCCCCXBBCCSPPP
PPPSCSBSCCBBBBBSCCSCBBSBCSSPPP
PPPCCCBCCBBBBBSCCBSCCCSBCCCPPP
PPPSCSBSCBBBSXDXDBDSCSSBSCSPPP
PPPCCCBSCCDSSDAAXBBBCCSBSCSPPP
PPPSCSBSSCSSCXAADBBSCSSBSCCPPP
PPPCCCBBSCCCCDXDXCCCCBBBSSCPPP
PPPSSCBBBSCSBBCCBBSSCBBBSSCPPP
PPPCCCBBBBCBBSSCSBXCCCBBCCCPPP
PPPCSSBBSCCBBDSCCCBSBCBBSCSPPP
PPPCCCBBBSCCCCCCDCCCCCBBSCCPPP
PPPSSCBBSSCXBSCSSBBCSBBBSSCPPP
PPPCCCBBBBSSSSSSBBBSBBBBSCCPPP
PPPCSSBBBBBBBBBBBBBBBBBBSCSPPP
PPPCSCCCCCCCCCCSSSSSSSSSCCCPPP
PPPCSCSCXCSCSSCCCSCSCSCCCCSPPP
PPPCCCSSSSSSSSSSCCCCCCCSXCSPPP
PPPPPPPPPPPPPPPPPPPPPPPPPPPPPP
PPPPPPPPPPPPPPPPPPPPPPPPPPPPPP
PPPPPPPPPPPPPPPPPPPPPPPPPPPPPP
000000000000000000000000000000
000000000000000000000000000000
000000000000000000000000000000
000111111111121121121212112000
000121121211211121111112212000
000111212112111222121212122000
000111444444444444444444111000
000221444444444444444444111000
000211445554444555444554111000
000221444555444555544554111000
000111444555454455544554121000
000111444444455444444544212000
000111444445444444444444222000
000222444445433334455544111000
000212444544432234455544111000
000222445544432234455544121000
000211445445433334444444222000
000222444455444444455544222000
000111454455445444445444121000
000112454555455544445444111000
000121454444444444545444111000
000111454454444554555444111000
000111454455554554444444221000
000121444444444444444444212000
000212111121211121212111221000
000222121121211111121121212000
000212112121212111212111212000
000000000000000000000000000000
000000000000000000000000000000
000000000000000000000000000000
