100
100
PPPPPPPPPPPPPPPPPPPPPPPPPPPPPPPPPPPPPPPPPPPPPPPPPPPPPPPPPPPPPPPPPPPPPPPPPPPPPPPPPPPPPPPPPPPPPPPPPPPP
PPPPPPPPPPPPPPPPPPPPPPPPPPPPPPPPPPPPPPPPPPPPPPPPPPPPPPPPPPPPPPPPPPPPPPPPPPPPPPPPPPPPPPPPPPPPPPPPPPPP
PPPPPPPPPPPPPPPPPPPPPPPPPPPPPPPPPPPPPPPPPPPPPPPPPPPPPPPPPPPPPPPPPPPPPPPPPPPPPPPPPPPPPPPPPPPPPPPPPPPP
PPPSSSSSSSSSSSSSSSSSSSSSSSSSSSSSSSSSSSCCSSSSSSSSSSCCSSSSCCSSSSSSSSSSSSSSSSSSSSCCSSSSSCCSSSSSCCSCCPPP
PPPSSSSSSSSSSSSSSSSSSSSSSSSSCSSSSSSSSSSCCSSSSSSSSCCCCSCCCCSSSSSSSSSSSSSSSSSSSSCCSSSSSCCSSSSCCSCCSPPP
PPPSSSSSSSSSSSSSSSSSSSSSSSCCCCSSSSSSSSSCCSSSSSSSSCCCCCCCSSSSSSSSSSSSSSSSSSSSSCCSSSSSCCSSSSSSCCSSSPPP
PPPSSSSSSSSSSSSSSSSSSSSSCCCCSCCCCSSSCSCCCSCSCCSCCCCSSCSSSSSSSSSSSSSSSSSSSSSSSSCCSSSSCCSSSSSSSCCSSPPP
PPPSSSSSSSSSSSSSSSSSSSSCCCSSSSCCCCCCCCCCSCDCCCCCCSCCSSSSSSSSSSSSSSSSSSSSSSSSSSCCSSSSSCCSSSSSSCCSSPPP
PPPSSSSSSSSSSSCSSSSSSCCCSSSSSSSSSCCCSCSCCCSCSSCSSCCSSSSSSSSSSSSSSSSSSSSSSSSSSSSCCSSSCCSSSSSSSCCSSPPP
PPPSSSSSSSSSSCCCSCCCCCCSSSSSSSSSSSSSSSSSCSSSSSSSSSCCSSSSSSSSSSSSSSSSSSSSSSSSSSSCCSSCCSSSSSSSSSCCSPPP
PPPSSSCCSSSSCCSCCCCCCSSSSSSSSSSSSSSSSSSSCCSSSSSSSSSCCSSSSSSSSSSSSSSSSSSSSSSSSSSSCCSCCSSSSSSSSCCCCPPP
PPPCSCCCCSCCCSSSCSSSSSSSSSSSSSSSSSSSSSSSCCSSSSSSSSSCCSSSSSSSSSSSSSSSSSSSSSSSSSSSCCSSCCSSSSSSSSCCSPPP
PPPCCCSSCCCCSSSSSSSSSSSSSSSSSSSSSSSSSSSSCCSSSSSSSSCCSSSSSSSSSSSSSSSSSSSSSSSSSSSSSCCCCCCCCCCCCCCCSPPP
PPPSCSSSSCSSSSSSSSSSSSSSSSSSSSSSSSSSSSSSSCCSSSSSSSSCCSSSSSSSSSSSSSSSSSSSSSSSSSSSCCSCCCMMMMMMMMMCSPPP
PPPSSSSSSSSSSSSSSSSSSSSSSSSSSSSSSSSSSSSSSSCCSSSSSSSCCSSSSSSSSSSSSSSSSSSSSSSSSSSCCSSSSCMCCCCCCCMCSPPP
PPPSSSSSSSSSSSSSSSSSSSSSSSSSSSSSSSSSSSSSSSCCSSSSSSCCSSSSSSSSSSSSSSSSSSSSSSSSSSSSSSSSSCMCCXCCCCMCSPPP
PPPSSSSSSSSSSSSSSSSSSSSSSSSSSSSSSSSSSSSSSSSCCSSSSSCCSSSSSSSSSSSSSSSSSSSSSSSSSSSSSSSSSCMCCCCCCCMCSPPP
PPPSSSSSSSSSSSSSSSSSSSSSSSSSSSSSSSSSSSSSSSSCCSSSSSCCSSSSSSSSSSSSSSSSSSSSSSSSSSSCCSSSSCMCCCCCCCMCSPPP
PPPSSSSSSSSSSSSSSSSSSSSSSSSSSSSSSSSSSSSSSSCCSSSSSSCCSSSSSSSSSSSSSSSSSSSSSSSSSSSSCCSSSCMCCCCCCCCCSPPP
PPPSSSSSSSSSSSSSSSSSSSSSSSSSSSSSSSSSSSSSSSCCSSSSSSSCCSSSSSSSSSSSSSSSSSSSSSSSSSSSSCCSSCMCCCCCCCMCSPPP
PPPSSSSSSSSSSSSSSSSSSSSSSSSSSSSSSSSSSSSSSCCSSSSSSSSCCSSSSSSSSSSSSSSSSSSSSSSSSSSSSCCSSCMCCCCCCCMCSPPP
PPPSSSSSSSSSSSSSSSSSSSSSSSSSSSSSSSSSSSSSSSCCSSSSSSSSCCSSSSSSSSSSSSSSSSSSSSSSSSSSCCSSSCMMMCMMMMMCSPPP
PPPSSSSSSSSSSSTTTTTTTSSSSSSSSSSSSSSSSSSSSSSCCSSSSSSCCSSSSSSSSSSSSSSSSSSSSSSSSSSSSCCSSCCCCCCCCCCCSPPP
PPPSSSSSSSSSSTTTTTTTTTSSSSSSSSSSSSSSSSSSSSCCSSSSSSCCSSSSSSSSSSSSSSSSSSSSSSSSSSSSSCCSCCSSSSSSSSCCSPPP
PPPSSSSSSSSSSTTBBBBBTTSSSSSSSSSSSSSSSSSSSSSCCSSSSSSCCSSSSSSSSSSSSSSSSSSSSSSCCCCCCCCCCCSSSSSSSCCSSPPP
PPPSSSSSSSSSSTTBBBBBTTSSSSSSSSSSSSSSSSSSSSSCCSSSSSSCCSSSSSSSSSSSSSSSSSSSSSSCMMMMMMMMMCSSSSSSSCCSSPPP
PPPSSSSSSSSSSTTBBBBBTTSSSSSSSSSSSSSSSSSSSSSSCCSSSSSCCSSSSSSSSSSSSSSSSSSSSSSCMCCCCCCCCCSSSSSSSSCCSPPP
PPPSSSSSSSSSSTTTTXTTTTSSSSSSSSSSSSSSSSSSSSSSSCCSSSSCCSSSSSSSSSSSSSSSSSSSSSSCMCXCCCCCMCSSSSSSSSCCSPPP
PPPSSSSSSSSSSTTTTTTTTTSSSSSSSSSSSSSSSSSSSSSSSSCCSSSCCSSSSSSSSSSSSSSSSSSSSSSCMCCCCCCCMCSSSSSSSCCSSPPP
PPPSSSSSSSSSSTTTTTTTTTSSSSSSSSSSSSSSSSSSSSSSSCCSSSCCSSSSSSSSSSSSSSSSSSSSSSSCMCCCCCCCMCSSSSSSSSCCSPPP
PPPSSSSSSSSSSTBBTTTBBTSSSSSSSSSSSSSSSSSSSSSSSCCSSSCCSSSSSSSSSSSSSSSSSSSSSSSCMCCCCCCCMCSSSSSCSSCCSPPP
PPPSSSSSSSSSSTBBTTTBBTSSSSSSSSSSSSSSSSSSSSSSSCCSSSSCCSSSSSSSSSSSSSSSSSSSSSSCCCCCCCCCMCSSSCCCCCCCCPPP
PPPSSSSSSSSSSTTTTTTTTTSSSSSSSSSSSSSSSSSSSSSSSCCSSSSSCCSSSSSSSSSSSSSSSSSSSSSCMCCCCCCCMCSSCCCSCCCSSPPP
PPPSSSSSSSSSSTTTTTTTTTSSSSSSSSSSSSSSSSSSSSSSSSCCSSSSSCCSSSSSSSSSSSSSSSSCSCCCMMMMMMMMMCCCCSSSSCCSSPPP
PPPSSSSSSSSSSTTTTTTTTTSSSSSSSSSSSSSSSSSSSSSSSCCSSSSSSCCSSSSSSSSSSSSSSCCCCCCCCCCCCCCCCCCCSSSSCCSSSPPP
PPPCCSSSSCCCSSTTTTTTTSSSSSSSSSSSSSSSSSSSSSSSSCCSSSSSSSCCSSSSSSSSSSSSCCCSCSSSSSSSSSCCCCSSSSSSSCCSSPPP
PPPCCCSSCCCCCCCCCCCSSCCSSSSSSSCSSSSSSSSSSSSSCCSSSSSSSCCSSSSSSSSSSSSCCSSSSSSSSSSSSSCCCCSSSSSSSCCSSPPP
PPPSSCCCCSSSCSSCCCCCCCCCCCSCCCCCCSCSSSSSSSSSCCCSSSSSSSCCSSSSSSSSCSCCSSSSSSSSSSSSSCCSSCCSSSSSSSCCSPPP
PPPSSSCCSSSSSSSSSSSCCSSCCCCCCCSCCCCCCSCSCSSCCCCCSSSSSSSCCSSSCSSCCCCSSSSSSSSSSSSSSSCCCCSSSSSSSCCSSPPP
PPPSSSSSSSSSSSSSSSSSSSSSSSCSSSSSSCSCCCCCCCCCCCSCCCCCCSCCSSCCCCCCSCSSSSSSSSSSSSSSSSSSCCSSSSSSSCCSSPPP
PPPSSSSSSSSSSSSSSSSSSSSSSSSSSSSSSSSSSCSCSCCCCSSSCCCCCCCCSCCCSCCSSSSSSSSSSSSSSSSSSSSCCCCSSSSSCCSSSPPP
PPPSSSSSSSSSSSSSSSSSSSSSSSSSSSSSSSSSSSSSSSCCSSSSSSSSSCTCCCTTTTTTTTTTSSSSSSSSSSSSSSSSCCSSSSSSSCCSSPPP
PPPSSSSSSSSSSSSSSSSSSSSSSSSSSSSSSSSSSSSSSCCSSSSSCCCCCCCCCCCTTTTTTTTTSSSSSSSSSTTTTTTTCCTTTSSSSSCCSPPP
PPPSSSSSSSSSSSSSSSSSSSSSSSSSSSSSSSSSSSSSSSCCSSSSCMMMMMMCMMCTTTTTTTTTSSSSSSSSSTTTBBTTCCTTTSSSSCCSSPPP
PPPSSSSSSSSSSSSSSSSSSSSSSSSSSSSSSSSSSSSSSSSCCSSSCMCCCCCCCMCTTBBBTTTTTTSSTTTTTTTTBBTCCCCTTSSSCCSSSPPP
PPPSSSSSSSSSSSSSSSSSSSSSSSSSSSSSSSSSSSSSSSCCSSSSCMCCCCCCCMCTTBBBTTTTTTTSSTTTTBBTTTTCCTCCTSSCCSSSSPPP
PPPSSSSSSSSSSSSSSSSSSSSSSSSSSSSSSSSSSSSSSCCDSSSSCMCCCCCCCMCTTBBBTTBTTTTSSTTTBBBTTTCCTTTCCSSSCCSSSPPP
PPPSSSSSSSSSSSSSSSSSSSSSSSSSSSSSSSSSSSSSSSCCSSSSCMCXCCCCCMCTTBBBTTBBTTTTSSTTBBBTTTTCXTTCCSSSCCSSSPPP
PPPSSSSSSSSSSSSSSSSSSSSSSSSSSSSSSSSSSSSSSSSCCSSSCMCCCCCCCMCTTBBBTTBBTTTTSSTTTBTTTTCCTTTCCSSSSCCSSPPP
PPPSSSSSSSSSSSSSSSSSSSSSSSSSSSSSSSSSSSSSSSSCCSSSCMCCCCCCCMCTTTTTTTBBTTTSSTTTTTTTTTCCTTTCCSSSSSCCSPPP
PPPSSSSSSSSSSSSSSSSSSSSSSSSSSSSSSSSTTTBBTTCCTTTTCMCCCCCCCMCTTBBTTTBBBTTTSSTTTTTBBTCCTTTCCSSSSSSCCPPP
PPPSSSSSSSSSSSSSSSSSSSSSSSSSSSSSCSSTTTTTTTTCCTTTCMMMMMMMMMCTTBBTTTTTTTTTTSSTTTTBBTTCCTCCTSSSSSSCCPPP
PPPSSSSSSSSSSSSSSSSSSSSSSSSSSCSCCCSCTTTTTTCCTTTTCCCCCCCCCCCTTTTTTTTTTTTTTSSTTTTBTTTTCCCCTSSSSSSCCPPP
PPPSSSSSSSSSSSSSSSSSSSSCCSCCCCDCSCCCCCTCTCCTCTTTTSSSSSTTCCTTTTTTTTCTTTTTSSTTTTTTTTCTTCCTTSCCCCCSCPPP
PPPSCSSSSSSSSSSSSSSSSCCCCCCCCSCSSSCTCCCCCTTCCCCTTSCSCSTTTCCTTCTCTCCCTTTSSTTTTSTTTCCCCCSCSCCCCCCCCPPP
PPPCCCSSTCTTTTCCCTSSCCCSSCSSSSSSSSSTTTCTCCXCTCCCTCCCCCSSSCCSCCCCCCSCCTTTCTTCCCCCCCTCSCCCCCSSSSSCSPPP
PPPCSCCSCCCCCCCCCCCCCSSSSSSSSSSSSSSTTTTTTCCTTTTCCCSCSCCCSCCCCSCSCSSSCCCCCCCCCCCCCTTTCCSSCSSSSSSSSPPP
PPPCSCCCCCCCCCCTTCCCSSSSSSSSSSSSSSSTTTTTCCTTTTTTCSSSSSCCCCSCSSSSSCSCCCCCTCCCTTTTTTTTSCSSSSSSSSSSSPPP
PPPCCCSCTXTTTTCCTTSSSSSSSSSSSSSSSSSTBBTCCTTTBBTTTSSSSSSCCSSSSSSSCCCCCTTTSSTCCTTTCTTTCCCSSSCCSSSSSPPP
PPPSCSSSTTTTTTTCCCSSSSSSSSSSSSSSCSSTBBTTCCTTBBTTTSSSSSSSCCSSSSSCCSCSTTTTTSSTCCTCCCTCCSCCCCCCCSSSSPPP
PPPSSSSSTTTTTTTTCCCSSSSSSSSCCSCCCCSTBBTTTCCTTTTTTSSSSSCSCCSSSCCCSSSSSSSSSSSSSCCCSCCCCCSCCCSSCCSSSPPP
PPPSSSSSTTBBBTTTTTCCSCCCSSCCCCCCSCCTTTTTCCTTTTTTTSSSSCCCSCCSCCCCSSSSSSSSSSSSSSCSSSCSSCCSSSSSSCCSCPPP
PPPSSSSSTTBBBTTBBTSCCCCCCCCSSCSSSSCCTTTTTCCTCCTTTCSSCCSCCCCCCCCCCCSSSCCCSSCCSCCSCCSSSCCSCSSCCSCCCPPP
PPPSSSSSTTTTTTTBBTSSCSSSCCSSSSSSSSSCCCCCCCTCCCTCCCCCCCCSCCCCCCCSCCCCCCCCSSCCCCCCCCCCSCCCCCCCCSSCCPPP
PPPSSSSSTTTTTTTTTTSSSSSSSSSSSSSSSSSSCCCCSCCCSSCCCSCCSCCCSCCCCSSSSSCCCSSSSSSSCSSCSSCCCCDCSCCSSSSSCPPP
PPPSSSSSSSSSSSSSSSSSSSSSSSSSSSSSSSSSSSSSSCCSSCCSSSSSSSSCCCSCSSSSSSSSSSSSSSSSSSSSSSSSCCCSSSSSSSSSSPPP
PPPSSSSSSSSSSSSSSSSSSSSSSSSSSSSSSSSSSSSSSCCCCCSSSSSSSSSCCSSSSSSSSSSSSSSSSSSSSSSSSSSSSSCCSSSSSSSSSPPP
PPPSSSSSSSSSSSSSSSSSSSSSSSSSSSSSSSSSSSSSSTCCCTTTTTTTTTTTCCSSSSSSSSSSSSSSSSSSSSSSSSSSSCCCCSSSSSSSSPPP
PPPSCSSSSSSSSSSSSSSSSSSSSSSSSSSSSSSSSSSSSCCTTTTTTBTTTTTCCSSSSSSSSSSSSSSSSSSSSSSSSSSSSSCCSSSSSSSSSPPP
PPPCCCCSSSSSSSSSSSSSSSSSSSSSSSSSSSSSSSSSCCCCTBBTTBBBBBTTCCSSSSSSSSSSSSSSSSSSSSSSSSSSSCCSSSSSSSSSSPPP
PPPCSCCCSCSCSSSSSSSSSSSSSSSSSSSSCSSSSSCCCDCCTBBTTTBBBTTCCSSSSSSSSSSSSSSSSSSSSSSSSSSSCCCCSSSSSSSSSPPP
PPPSSSSCCCCCCSSCCCCCCCCCCCCCSSSCCCCSCCCCSCCTTTTTTTTTTTTCCSSSSSSSSSSSSSSSSSSSSSSSSSSSSCCSSSSSSSSSSPPP
PPPSSSSSCSCSCCCCMMMMMMMMMCCCCCCCSCCCCCSSCCTTTTTTTTTTTTTCCSSSSSSSSSSSSSSSSSSSSSSSSSSSSCCSSSSSSSSSSPPP
PPPSSSSSSSSSSCCCMCCCCCCCMCSSCCCSSSSCSSSCCTTTTTTTTTTTTTTCCSSSSSSSSSSSSSSSSSSSSSSSSSSSSCCSSSSSSSSSSPPP
PPPSSSSSSSSSSSSCMCCCCCCCMCSSSSSSSSSSSSSCCTTTTTTTXTTTTTCCTSSSSSSSSSSSSSSSSSSSSSSSSSSSSCCSSSSSSSSSSPPP
PPPSSSSSSSSSSSSCMCCCXCCCMCSSSSSSSSSSSSSSCCTTTTTTTTTTTCCTTSSSSSSSSSSSSSSSSSSSSSSSSSSSSSCCSSSSSSSSSPPP
PPPSSSSSSSSSSSSCCCCCCCCCCCSSSSSSSSSSSSSCCTTTTBBTTTTTCCTTTSSSSSSSSSSSSSSSSSSSSSSSSSSSSCCSSSSSSSSSSPPP
PPPSSSSSSSSSSSSCMCCCCCCCMCSSSSSSSSSSSSSCCTTTBBBTTTTTTCCTTSSSSSSSSSSSSSSSSSSSSSSSSSSSCCSSSSSSSSSSSPPP
PPPSSSSSSSSSSSSCMCCCCCCCMCSSSSSSSSSSSSCCSTTTBBBTTTBBTTCCTSSSSSSSSSSSSSSSSSSSSSSSSSSSCCSSSSSSSSSSSPPP
PPPSSSSSSSSSSSSCMCCCCCCCMCSSSSSSSSSSSCCSSSTTBBBTTTBBTCCTTSSSSSSSSSSSSSSSSSSSSSSSSSSSSCCSSSSSSSSSSPPP
PPPSSSSSSSSSSSSCMMMMMMMMMCSSSSSSSSSSSCCSSTTTTTTTTTTTTTCCTSSSSSSSSSSSSSSSSSSSSSSSSSSSSSCCSSSSSSSSSPPP
PPPSSSSSSSSSSSSCCCCCCCCCCCSSSSSSSSSSCCSSSTTTTTTTTTTTTTCCTSSSSSSSSSSSSSSSSSSSSSSSSSSSSCCSSSSSSSSSSPPP
PPPSSSSSSSSSSSSSSSSSSSSSSSSSSSSSSSSSCCSSSTTTTTTTTTTTTCCTTSSSSSSSSSSSSSSSSSSSSSSSSSSSSCCSSSSSSSSSSPPP
PPPSSSSSSSSSSSSSSSSSSSSSSSSSSSSSSSSSCCSSSSSSSSSSSSSSCCSSSSSSSSSSSSSSSSSSSSSSSSSSSSSSSCCSSSSSSSSSSPPP
PPPSSSSSSSSSSSSSSSSSSSSSSSSSSSSSSCCCCCCCCCCCSSSSSSSCCSSSSSSSSSSSSSSSSSSSSSSSSSSSSSSSSCCSSSSSSSSSSPPP
PPPSSSSSSSSSSSSSSSSSSSSSSSSSSSSSSCMCMMMMMMMCSSSSSSSSCCSSSSCSSSSSSSSSSSSSSSSSSSSSSSSSSSCCSSSSSSSSSPPP
PPPSCSSSSSSSSSSSSSSSSSSSSSSSSSCCCCMCCCCCCCMCSCSSSCSCSCCCSCCCSCSSSSSSSSSSSSSSSSCCSSSSSCCSSSSSSSSSSPPP
PPPCCCSSSSSSSSSSSSSSSSSSSSCSCCCCCCMCCCCCCCMCCCCSCCCCCCSCCCSCCCCSSSSSSSSSCSSSSCCCCSSSSSCCSSSSSSSSSPPP
PPPCSCCCSSSSSSSSCSSSSSSSSCCCCCSSSCMCCCCCCCMCCSCCCSCCCSSSCSSSCSCCCSCCSSSCCCSSCCSSCCSSSCCCCSSSSCSCSPPP
PPPSSSCCCSSSSSCCCCSCSSSSCCSCSSSSSCMCCCXCCCMCSSSCSSSCCSSSSSSSSSSCCCCCCCCCSCCCCSSSSCCSSSCCCCCCCCCCCPPP
PPPSSSSSCCCSCCCCSCCCCCSCCSSSSSSSSCMCCCCCCCMCSSSSSSCCSSSSSSSSSSSSSCSSCCCSSSCCSSSSSSCCSCCCCCCCCSCSCPPP
PPPSSSSSSCCCCCSSSSCSCCCCSSSSSSSSSCMCCCCCCCMCSSSSSCCSSSSSSSSSSSSSSSSSSSSSSSSSSSSSSSSCCCCCCCSSSSSSSPPP
PPPSSSSSSSSCSSSSSSSSSSCSSSSSSSSSSCMCCCCCCCMCSSSSSCCSSSSSSSSSSSSSSSSSSSSSSSSSSSSSSSSSCSCCCCSSSSSSSPPP
PPPSSSSSSSSSSSSSSSSSSSSSSSSSSSSSSCMMMMMMCMMCSSSSSSCCSSSSSSSSSSSSSSSSSSSSSSSSSSSSSSSSSCCSCCSSSSSSSPPP
PPPSSSSSSSSSSSSSSSSSSSSSSSSSSSSSSCCCCCCCCCCCSSSSSCCSSSSSSSSSSSSSSSSSSSSSSSSSSSSSSSSSCCSCCSSSSSSSSPPP
PPPSSSSSSSSSSSSSSSSSSSSSSSSSSSSSSSSCCSSSSSSSSSSSSSCCSSSSSSSSSSSSSSSSSSSSSSSSSSSSSSSCCSCCSSSSSSSSSPPP
PPPSSSSSSSSSSSSSSSSSSSSSSSSSSSTTTTTTCCTTSSSSSSSSSSSCCSSSSSSSSSSSSSSSSSSSSSSSSSSSSSCCSSSCCSSSSSSSSPPP
PPPPPPPPPPPPPPPPPPPPPPPPPPPPPPPPPPPPPPPPPPPPPPPPPPPPPPPPPPPPPPPPPPPPPPPPPPPPPPPPPPPPPPPPPPPPPPPPPPPP
PPPPPPPPPPPPPPPPPPPPPPPPPPPPPPPPPPPPPPPPPPPPPPPPPPPPPPPPPPPPPPPPPPPPPPPPPPPPPPPPPPPPPPPPPPPPPPPPPPPP
PPPPPPPPPPPPPPPPPPPPPPPPPPPPPPPPPPPPPPPPPPPPPPPPPPPPPPPPPPPPPPPPPPPPPPPPPPPPPPPPPPPPPPPPPPPPPPPPPPPP
0000000000000000000000000000000000000000000000000000000000000000000000000000000000000000000000000000
0000000000000000000000000000000000000000000000000000000000000000000000000000000000000000000000000000
0000000000000000000000000000000000000000000000000000000000000000000000000000000000000000000000000000
0002222222222223333334444444444433334455444333344455444455444433322112233334445543344554334455455000
0002222222333333333334444444544443334445544443344555545555444333322112233334445543344554334554554000
0003333333333333333344444455554444444445544444444555555544433333222112233344455443345544334455444000
0003333333333444444444445555455554445455545455455554454444333333222112233334445543345544334445544000
0003333443444444444444455544445555555555455555555455444443333332222112233334445544444554333445544000
0004444444444454444445554444444445554545554544544554444433333332211112233333444554445543333445544000
0004444444444555455555544444444444444444544444444455444433333322211122233333444554455444333444554000
0004445544445545555554444433333344444444554444444445544433333222211122233333344455455444444445555000
0005455554555444544444443333333333333444554444444445544333332222221112222233344455445544444444554000
0005554455554444444444433333333333333344554444344455444333332222211112112233344445555555555555554000
0004544445444444443333333333333333333334455444344445544333322222210111112233344455455555555555554000
0004444444443333333333333322222222223334445544434445544333322222110111112233344554444555555555554000
0004333344433333333333333322222222223334445544434455444333322222110000122233344444444555555555554000
0003333333333333333333333322211222223334444554434455444333322221100000122233344444444555555555554000
0003333333333333334443333332211112223334444554434455444333322221100111122233344554444555555555554000
0002223333333344444444433332211111223334445544434455444333322221001111123333344455444555555555554000
0002222233334444444444443332221001222334445544434445544333322221011112223333344445544555555555554000
0002222233344444444444444333221001222334455444333445544333322221011122233333344445544555555555554000
0001112233444444444444444333221111122334445544333444554333322221112222333333344455444555555555554000
0001112233444455555554444333321111122334444554433445544333322211112222333344444445544555555555554000
0000012233444555555555444433322111122333445544443455444333322210122223333444444445545544444444554000
0001112233444555555555444433322221122333344554443445544433322210122223333445555555555544444445544000
0001122233444555555555444333322222222333344554443445544433322211122223333445555555555544333445544000
0002222233444555555555444333222222222233344455443445544433322211122233333445555555555544333444554000
0002222233444555555555444333222332222233334445544445544433322222222233334445555555555544333444554000
0002223334444555555555444333233333222223334444554445544433322222222233334445555555555544434445544000
0003333334444555555555444333333333333223334445544455444433322222222333334445555555555544444444554000
0003333344444555555555444333333333333323334445544455444443322222333333344445555555555544444544554000
0003333444444555555555444333333333333333334445544445544443322223333333444445555555555544455555555000
0004444444444555555555444333334433333333334445544444554443333333333334444445555555555544555455544000
0004444444444555555555444433444443344333334444554344455443333333333344454555555555555555544445544000
0004444444444555555555444444444444444433344445544334455443333333334445555555555555555555443455444000
0005544445554455555554444444444444444444444445544334445543333333344455545444444444555544433445544000
0005554455555555555445544444445444444444444455444334455444444444444554444444444444555544334445544000
0004455554445445555555555545555554544444444455544444445544444444545544444333333345544554333344554000
0004445544444444444554455555554555555454544555554444444554445445555444433332333344555544333445544000
0003444444444444444444444454444445455555555555455555545544555555454443332222333344445544433445544000
0003444444334444444444444444444444444545455554445555555545554554444444333333344444455554443455444000
0003334443334333333444444444444444444444445544444444455555555555555544333333444444445544443445544000
0003333333333333333333333333343333344444455444445555555555555555555544334444455555555555543444554000
0003333333333322333333333333333333333334445544445555555555555555555544444444455555555555544445544000
0002333333223322233333333333333333333333444554445555555555555555555555445555555555555555544455443000
0002222222222222222222222222332222233333445544445555555555555555555555544555555555555555544554433000
0002222222222111122222222222222222233334455544445555555555555555555555544555555555555555544455443000
0002222222222222222222222222233333333344445544445555555555555555555555554455555555555555543455443000
0003333333222222222223333333333333334444444554445555555555555555555555554455555555555555543345544000
0003333333333333333333333333333344444444444554445555555555555555555555544555555555555555543344554000
0003333333333333333333333333334444455555555555555555555555555555555555554455555555555555543334455000
0004433333333333333333444444444454455555555555555555555555555555555555555445555555555555543334455000
0004444444443334443344444444454555455555555555555555555555555555555555555445555555555555544444455000
0004444444444444444444455455555545555555555555555444445555555555555555554455555555555555545555545000
0004544444444444444445555555545444555555555555555454545555555555555555544555545555555545455555555000
0005554455555555554455544544444444455555555555555555554445545555554555555555555555554555554444454000
0005455455555555555554444444444334455555555555555545455545555454544455555555555555555544544444443000
0005455555555555555544443433333344455555555555555444445555454444454555555555555555554544444443333000
0005554555555555554444433334444444455555555555555444444554444444555555554455555555555554445544333000
0004544455555555554444444444444454455555555555555443444455444445545455555445555555555455555554443000
0004444455555555555444444445545555455555555555555444445455444555444444444444455545555545554455444000
0003444455555555555545554455555545555555555555555444455545545555444444444444445444544554444445545000
0003334455555555554555555554454444555555555555555544554555555555554445554455455455444554544554555000
0003334455555555554454445544444444455555555555555555555455555554555555554455555555554555555554455000
0003334455555555554444444444444444445555455544555455455545555444445554444444544544555555455444445000
0003333444444444444333334433333333444444455445544444444555454444444444444444444444445554444443444000
0004443344444444444333333333333333344444455555444444444554444433344444444444444444444455444433334000
0004444333333433333333333333333333344334405555555555555555444433333433333443333334444555533333333000
0004544444443334444444444333334444333344455555555555555554443333333333333333333333444455433333333000
0005555444444444444444444444444444444444555555555555555555443333333333333333333333344554433333333000
0005455545454444444444444444444454444455555555555555555554443333333333333333333333345555433332223000
0004444555555445555555555555444555545555455555555555555554433332223333222332222333344554333222222000
0004344454545555555555555555555545555544555555555555555554433332222332222222222233344554433222222000
0003334444444555555555555544555444454445555555555555555554433322222222222222222233344554433222222000
0003333344444445555555555544444444444445555555555555555554433322212222211211112233344554433222222000
0002233334333445555555555544444433443344555555555555555554433322112222211111112233344455433322211000
0002223333333445555555555543343333333445555555555555555554433322111111111122211233344554433322211000
0001222333333345555555555543333332333445555555555555555554433322211111122222222233345544433322111000
0001112222223345555555555543333222334455455555555555555554433322222222222222222223345544433322111000
0002211112222345555555555543222222334554445555555555555554433322222222222222222223334554433322222000
0002222222112345555555555543322223334554455555555555555554433332222222222223333222334455433322222000
0003222222222345555555555543322333345544455555555555555554433333333332222333333332334554433322222000
0003333332222344444444444443333333445544455555555555555554443333333333333333333333334554333322322000
0003333333333344444444444443333344445544444444444444554444444433333333333333334433334554333333333000
0004444333333343333333334444444445555555555544444445544444444443333333333333344443334554433333333000
0004444433333344333333333444444445555555555544444444554444544444444333444433444444334455433333333000
0004544444333344444333334444445555555555555545444545455545554544444444444444445544444554443334443000
0005554444433444444444344454555555555555555555545555554555455554444444445444455554444455444444444000
0005455544444444544444444555554445555555555554555455544454445455545544455544554455444555544445454000
0004445554444455554544445545444445555555555544454445544444444445555555554555544445544455555555555000
0004444455545555455555455444443345555555555544444455443443334444454455544455444444554555555554545000
0003334445555544445455554443433335555555555543344554443333333333444444444444433334455555554444444000
0003333444454444344444544333333345555555555543334554443333333333344334443344433334445455554433344000
0003333344444433334444443333333445555555555543334455443332233333333333333333333334444554554333333000
0002233333343333333333433323344445555555555543334554443332222233333333333333333334445545543332223000
0002223333333332223333332223444444455444444443334455443322222222222233333332233344455455443322222000
0002223333333322223333322233445555555555444433334445543322112222222222222222233444554445543322222000
0000000000000000000000000000000000000000000000000000000000000000000000000000000000000000000000000000
0000000000000000000000000000000000000000000000000000000000000000000000000000000000000000000000000000
0000000000000000000000000000000000000000000000000000000000000000000000000000000000000000000000000000
