100
100
PPPPPPPPPPPPPPPPPPPPPPPPPPPPPPPPPPPPPPPPPPPPPPPPPPPPPPPPPPPPPPPPPPPPPPPPPPPPPPPPPPPPPPPPPPPPPPPPPPPP
PPPPPPPPPPPPPPPPPPPPPPPPPPPPPPPPPPPPPPPPPPPPPPPPPPPPPPPPPPPPPPPPPPPPPPPPPPPPPPPPPPPPPPPPPPPPPPPPPPPP
PPPPPPPPPPPPPPPPPPPPPPPPPPPPPPPPPPPPPPPPPPPPPPPPPPPPPPPPPPPPPPPPPPPPPPPPPPPPPPPPPPPPPPPPPPPPPPPPPPPP
PPPTTTTTTTTTTTAAATTTTTTTTTTTTTTTTTTTTTTTTTTMMMMMMCCMMMMMTTTTTTTTBBBBBBTTTTTTTTTTTTTTTTTTTAABBBBBBPPP
PPPTTTTTTTTTTTAATTTTTTTTTTTTTTTTTTTTTTTTTMMMMMMMMDDMMMMMMTTTTTBBBBBBBBTTTTTTTTTTTTTTTTTTAAABBBBBBPPP
PPPTTTTTTTTTTAAATTTTTTTTTTTTTTTTTTMMMMMMMMMMMMMMMDDMMMMMMMMMMMMMBBBBBBTTTTTTTTTTTTTTTTTTAABBBTBTTPPP
PPPTTTTTTTTTAAATTTTTTTTTTTTTTTTTTTMMMMMMMMMCCCCCCCCCCCCMMMMMMMMMMBBBBBBTTTTTTTTTTTTTTTTAABBBBTBTTPPP
PPPTTTTTTTTTAATTTTTTTTTTTTTTTTTTMMMMMMMMMMCCCCCCCCCCCCCCMMMMMMMMMMMBBBBBTTTTTTTTTTTTTTTAABBBBBBTTPPP
PPPTTTTTTTTAAATTTTTTTTTTTTTTTTMMMMCCCCCCCCCCSSSSSCCSSSCCCCCCCCCCMMMMMMMBBTTTTTTTTTTTTTAABBBBBBBTTPPP
PPPTTTTTTTTAATTTTTTTTTTTTTTTTMMMMMCCCCCSCSSSSSSSSCCSSSXXCCCCCCCCCMMMMMMMBTTTTTTTTTTTTTAABBBBBBTTTPPP
PPPTTTTTTTAATTTTTTTTTTTTTTTMMMMMCCCSSSSSSSSSSSSSSCCSSSXXSSSSSSSCCCCCCMMMMMBBTTTTTTTTTTAABBBBTTTTTPPP
PPPTTTTTTTAATTTTTTTTTTTTMMMMMMMCCSSSSSSSSSSSSSSSSCCSSSSSSSSSSSSSCCCCCCMMMMMBTTTTTTTTTTAABBBBBBTTTPPP
PPPTTTTTTTAATTTTTTTTTTTMMMMMMCCCCSSSSSSSSSSSSSSSSCCSSSSSSSSSSSSSSSSCCCCMMMMMTTTTTTTTTTAABBBBBBBTTPPP
PPPTTTTTTAAATTTTTTTTTTMMMMMCCCCSSSSSSSSSSSSSSSSSSCCSSSSSSSSSSSSSSSSSSCCCCMMMMTTTTTTTTTTABBBBBBBTTPPP
PPPTTTTTAATTTTTTTTTTMMMMMMCCCCSSSSSSSSSSSSSSSSSSSCCSSSSSSSSSTTTTTSSSSSCCCCMMMMMBBTTTTTTAABBBBBBTTPPP
PPPTTTTAAATTTTTTTTTMMMMMCCCSSSSSSSSSSSSSSSSSSSSSSCCSSSSSSSSSTTTTTSSSSSSCCCCMMMMMBBTTTTTAABBBBBBBTPPP
PPPTTTAAATTTTTTTTTMMMMMCCCCSSSSSSSSSSSSSSSSSSSSSSCCSSSSSSSSSTSSSTSSSSSSSSCCCMMMMMBBTTTTTAABBBBBBTPPP
PPPTTAAATTTTTTTTTMMMMMCCCCCSSSSSSSSSTTTTTSSSSSSSSCCSSSSSSSSSTSTSTSSSSSSSSCCCCMMMMMBBTTTTAAABBBBBTPPP
PPPTAAATTTTTTTTTMMMMCCCCCCCCCSSSSSSSTTTTTSSSSSSTTCCTTSSSSSSDTSSSTSSSSSSSCCCCCCCMMMMBTTTTTAAABBBTTPPP
PPPAAATTTTTTTTTTMMMMCCCSSCCCCSSSSSSSTSSSTSSSSSSTTCCTTSSSSSSSTTTTTSSSSSSSCCTTCCCCMMMMTTTTTTAABBBBTPPP
PPPAATTTTTTTTTTMMMMCCCSSSSCCCCSSSSSSSSTSSSSSSSSSSCCTTSSSSSSSTTTTTSSSSSSCCCTTTCCCCMMMMTTTTTTAAABBBPPP
PPPATTTTTTTTTTMMMMCCCSSSSSCCCCCSSSSSTSSSTSSSSSSSSCCTTSSSSSSSSSSSSSSSSSCCCSSTTTCCCCMMMMBBTTTBAABBBPPP
PPPTTTTTTTTTTMMMMCCCCSSSSSCCCCCSSSSSTTTTTSSSSSSSSCCTTSSSSSSSSSSSSSSSSSCCSSSSTTTCCCCMMMMBTTTBBAABBPPP
PPPTTTTTTTTTMMMMCCCTTSSSSSCCCCCCSSSSTTTTTSSSSSSSSCCSSSSSSSSSSSSSSSSSCCCSSSSSSTTSCCCCMMMBTTTTBBAABPPP
PPPTTTTTTTTMMMMCCCTTTSSSSSCCCCCCSSSSSSSSSSSSSSSSSCCSSSSSSSSSSSSSSSSSCCCSSSSSSSDSSCCCCMMMTTTTTBAABPPP
PPPTTTTTTTTMMMCCCTTTSSSSSSCCCCCCCSSSSSSSSSSSSSSTTCCTTSSSSSSSSSSSSSSCCCSSSSSSSSSSSSSCCCMMMTTTTBBAAPPP
PPPTTTTTTTTMMMCCCTTDSSSSSSSCCCCCCCSSSSSSSSSSSSTTTCCTTTSSSSSSSSSSSSCCCSSSSSSSSSSSSSSSCCCMMTTTTTBBBPPP
PPPTTTTTTMMMMCCCSSSSSSSSSSSSCCCCCCCSSSSSSSSSSTTTTCCTTTTSSSSSSSSSSSCCCSSSSSSSSSSSSSSSCCCMMMTTTTBBBPPP
PPPTTTTTTMMMCCCSSSSSSSSSSSSSSCCCCCCSSSSSSSSSSTTTCCCCTTTSSSSSSSSSSSCCSSSSSSSSSSSSSSSSSCCMMMMTTTTBBPPP
PPPTTTTTTMMMCCSSSSSSSSSSSSSSSTTCCCCCCSSSSSSSSTTTCBBCTTTSSSSSSSTTSCCSSSSSSSSSSSSSSSSSSCCMMMMMTTTBBPPP
PPPTTTTTMMMCCSSSSSSSSSSSSSSSSTTTCCCCCSSSSSSSSTTTCBBCTTTSSSSSSTTTCCCSSSSSSSSSSSSSSSSSSSCCCMMMTTTTBPPP
PPPTTTTTMMCCCSSSSSSSSSSSSSSSSTTTCCCCCSSSSSSSSTTTCCCCTTTSSSSSTTTCCCTTSSSSSSSSSSSSSSSSSSCCCCMMTTTTTPPP
PPPTTTTMMMCCSSSSSSSSSSSSSSSSSSSSSCCCCCSSSSSSSTTTTCCTTTTSSSSSTTTCCSTTSSSSSSSSSSSSSSSSSSSSCCMMMMTTTPPP
PPPTTTMMCCCSSSSSSSSSSSSSSSSSSSSSSCCCCCSSSSSSSSTTTCCTTTSDSSSSSTCCCSSSSSSSSSSSSSSSSSSSSSSSCCMMMMTTTPPP
PPPTTTMMCCCSSSSSSSSSSSSSSSSSSSSSTTCCCCCSSSSSSSSTTCCTTSSSSSSSSCCCSSSSSSSSSSSSSSSSSSSSSSSSCCCMDCTTTPPP
PPPTTTMMCCSSSSAAAAASSSSSSSSSSSSSTTCCCCCCSSSSSSSSSCCSSSSSSSSSCCSSSSSSSSSSSSSSSSSSSSSSSSSSSCCDDDCTTPPP
PPPTTTCDCCSSSSAAAAASSSSSSSSSSSSSSSSSCCCCCCSSSSSSSCCSSSSSSSSCCCSSSSSSSSSSSSSSSSSDAAAASSCCCCCCCDCTTPPP
PPPTTTCDCCCCCSSSSSDSSSSSSSSSSSSSSSSSCCCCCCSSSSSSSCCSSSSSSSSCCSSSSSSSSSSSSSSSSSSSAAAASSCCCCCCCMMMTPPP
PPPTTMDDCCCCCCCCSSSSSSSSSSSSSSSSSSSSSCCCCCCSSSSSSCCSSSSSSCCCCSSSSSSSSSSSSSSSSSSSCCCCCCCCCCCCCMMMTPPP
PPPTMMMCCSCCCCCCCSSSSSSSSSTTTTTTSSSSSSCCCCCCSSSSSCCSSSSSSCCSSSSSSSSSSTTTTTTSSSSSCCCCCCCSSSSCCMMMTPPP
PPPTMMCCCSSSSSCCCCCSSSSSSTTTTTTTTSSSSSCCCCCCCSSSSCCSSSSSSCCSSSSSSSSSTTTTTTTTCCCCCCCCCCCSSSSCCMMMTPPP
PPPTMMCCSSSSSSSSSSCCCCSSTTTTAATTTTSSSSSCCCCCCSSSSCCSSSSSCCSSSSSSSSSTTTTTTTTDCCCCCSSSSSSSSSSCCMMMTPPP
PPPTMMCCSSSSSSSSSSSCCCCCCCTCAACTTTSSSSSSCCCCCCSSSCCSSSSSCSSSSSSSSSSTTCCCCCCCCCCSSSSSSSSSSSSCCMMMTPPP
PPPTMMCCSSSSSSSSSSSSSSCCCCCCBBCCTTSSSSSSSCCCCCCCSCCSSSSCSSSSSSSCCCCCCCCBBCCCTSSSSSSSSSSSSSSCCMMMTPPP
PPPTMMCCSSSSSSSSSSSSSSSSTTCCBBCCCCCCSSSSSSCCCCCCCCCCCCCCCSSSSSCCCCCCCCCBBCTTTSSSSSSSSSSSSSSCCMMMTPPP
PPPTMMCCSSSSSSSSSSSSSSSSTTTCCCCTCCCCSSSSSSSCCCCCCCCCCCCCCSSSSCCSSSSTTTCCCCTTTSSSSSSSSSSSSSSCCMMMTPPP
PPPTMMCCSSSSSSSSSSSSSSSSTTTTTTTTTTCCCCCSSSSCCXXXXXXXXXXCCSSCCCSSSSSTTTTAATTTTSSSSSSSSSSSSSSCCMMMTPPP
PPPTMMCCSSSSSSSSSSSSSSSSSTTTTTTTTSXXCCCCCCCCCXXXXXXXXXXCCCCCSSSSSSSSTTTAATTTSSSSSSSSSSSSSSSCCMMMMPPP
PPPTMMCCSSSSSSSSSSSSSSSSSSTTTTTTSSXXSSSSCCCCCXXXXXXXXXXCCCSSSSSSSSSSSTTTTTTSSSSSSSSSSSSSBBSCCMMMMPPP
PPPMMMCCSSSSSSSSSSSSSSSSSSSSSSSSSSSSSSSSSCCCCXXXXXXXXXXCCSSSSSSSSSSSSSSSSSSSSSSSSSSSSSSSBBSCCMMMMPPP
PPPMMMCCSSSSSSSSSSSSSSSSSSSSSSSSSSSSSTBTSSSCCXXXXXXXXXXCCSSSSSSSSSSSSSSSSSSSSSSSSSSSSSSDTTSCCCMMMPPP
PPPMMMCCSSSSSSSSSSSSSSSSSSSSSSSSSSSSSBTBSSSCCXXXXXXXXXXCCCCSSSSSSSSSSSSSSSSSSSSSSSSSSSSSBBSCCMMMBPPP
PPPMMMCCSSSSSSSSSSSSSSSSSSSSSSSSSSSSSSSSCCCCCXXXXXXXXXXCCCCCCSSSSSSSSSSSSSSSSSSSSSSSSSSSBBSCCMMMBPPP
PPPMMMCCSSSSSSSSSSSAAAASSSSSSSSSSSSSCCCCCCCCCXXXXXXXXXXCCCCCCCCSSSSSSSSSSSSSSSSSSSSSSSSSTTSCCMMMBPPP
PPPTMMCCSSSSSSSSSSSAAAADDSSSTTTSSCCCCCCCCCCCCXXXXXXXXXXCCSSCCCCCSSSSSSSSSSSSSSSSSSSSSSSSSSSCCMMMBPPP
PPPTMMCCSSSSSSSSSSSAAAABBSSSTTTSSCCCCCCCSSSCCXXXXXXXXXXCCSSSSCCCCCCCSSSSTTTTSSSSSSSSSSSSSSSCCMMMBPPP
PPPTMMCCSSSSSSSSSSSAAAABBSSSCCCCCCCCCTTSSSSSCCCCCCCCCCCCCSSSSSCCCCCCCCCCTTTTSSSSSSSSSSSSSSSCCMMMBPPP
PPPTMMCCSSSSSSSSSSSSSSSSSCCCCCCCCSTTTTTSSSSCCCCCCCCCCCCCCCSSSSSSSSCCCCCCCCCCSSSSSSSSSSSSSSSCCMMMBPPP
PPPTMMCCSSSSSSSSSSSSSCCCCCCCCCSSSSTTTSSSSSSCCSSSSCCSSSSCCCSSSSSSSSSCCCCCCCCCCCCCSSSSSSSSSSSCCMMBBPPP
PPPTTMCCSSSSSSSSSCCCCCCCCCCSSSSSSSSSSSSSSSCCCSSSSCCSSSSSCCSSSSSSSSSSSSSSCCCCCCCCCCSSSSSSSSCCCMMBBPPP
PPPTTMMCCSSSSSCCCCCCCCCCSSSSSSSSSSSSSSSSSSCCSSSSSCCSSSSSCCCSSSSSSSSSSSSSSSSSSCCCCCCCCSSSSSCCMMMBBPPP
PPPTTMMCCSSSSCCCCCCCCSSSSSSSSSSSSSSSSSSSSCCSSSSSSCCSSSSSSCCCSSSSSSSSSSSSSSSSSSSSCCCCCCCCCCCCMMMBBPPP
PPPTTMMCCSCCCCCCCSSSSSSSSSSSSSSSSSSSSSSSSCCSSSSSSCCSSSSSSCCCSSSSSSSSSSSSSSSSSSSSSSSCCCCCCCCCMMMBBPPP
PPPTTMMMCCCCCCSSSSSSSSSSSSSSSSSSSSTTTTTTCCSSSSSSSCCSSSSSSSCCTTTTTTSSSSSSSSSSSSSSSSSSSSCCCCCMMMBBBPPP
PPPTTMMMCCCSSSSSSSSSSSSSSSSSSSSSSTTTTTTCCCSSSSSSSCCSSSSSSSCCCTTTTTTSSSSTSSSSSTTTTTTSSSSSSCCMMMBBBPPP
PPPTTTMMCCSSSSSSSSSSSSSSSSSSSSSSTTTTTTCCTTSSSSSSSCCSSSSSSSTCCCTTTTTTSSSSSSSSSTBBTTTSSSSSSCCMMBBBBPPP
PPPTTTMMCCSSSSSSSSSSSSSSSSSSSSSSTTTCCCCTTTSSSSSSSCCSSSSSSSTTCCCCCTTTSSSSSSSSDTTTTBBSSSSSSCCMMBBBBPPP
PPPTTMMMCCSSSSSSSSSSSSSSSSSSSSSSTTTCBBCTTTSSSSSSSCCSSSSSSSTTTCBBCTTTSSSSSSSSSTTTTTTSSSSSCCMMMBBBBPPP
PPPTTMMMCCCSSSSSSSSSSSSSSSSSSSSSTTTCBBCTTTSSSSSTTCCSSSSSSSTTTCBBCTTTSSSSSSSSSBBTTTTSSSSSCCMMMBBBBPPP
PPPTTTMMMCCCSSSSSSSSSSSAAADSSSSSTTTCCCCTTTSSSSSTTCCSSSSSSSTTTCCCCCTTSSSSSSSSSSSSSSSSSSSCCMMMBBBBBPPP
PPPTTTMMMMCCSSSSSSSSSSSAAASSSSSSTTCCTTTTTTSSSSSTTCCSSSSSSSTTTTTTCCTTSSSSSSSSSSSSSSSSSSSCCMMMBBBBBPPP
PPPTTTTMMMCCCSSSSSSSSSSAAASSSSSSDCCTTTTTTSSSSSSTTCCSSSSSSSSTTTTTTCDSSSSSSSSSSSSSSSSSSSCCMMMBBBBBBPPP
PPPTTTTTMMMCCCSSSSSSSSSAAASSSSSSCCCTTTTTSSSSSSSTTCCSSSSSSSSSTTTTTCCSSSSSSSSSSSSSSSSSSCCCMMBBBBBBAPPP
PPPTTTTTTMMMCCSSSSSSSSSAAASSSSSSCCSSSSSSSSSSSSSTTCCSSSSSSSSSSSSSSCCCSSSSSSSSSSSSSSSSCCCMMMBBBBBAAPPP
PPPTTTTTTTMMCCCCSSSSSSSSSSSSSSSSCCSSSSSSSSSSSSSSSCCSSSSSSSSSSSSSSSCCCSAAAAASSSSSSSSSCCCMMBBBBBAAAPPP
PPPTTTTTTTMMMCCCSSSSSSSSSSSSSSSCCSSSSSSSSSSSSSSSSCCSSSSSSSSSSSSSSSCCCCAAAAASSSSSSSSCCMMMMBBBBAAABPPP
PPPTTTTTTTMMMMCCCSSSSSSSSSSSSSCCSSSSSSSSSSSSSSSSSCCSSSSSAAAASSSSSSSCCCSSDAASSSSSSSCCCMMMBBBBAAAABPPP
PPPTTTTTTTTMMMMCCCSSSSSSSSSSSCCCSSSSSSSSSSSSSSSSSCCTTSSSAAAADSSSSSSSCCCSSAASSSSSSCCCMMMABBBBAABBBPPP
PPPTTTTTTTTTMMMCCCCSSSSSSSSSSCCSSSSSSSSSSSSSSSSSSCCTTSSSSSSSSSSSSSSSCCCCSAASSSSCCCCCMMAAABBBAABBBPPP
PPPTTTTTTTTTTMMMCCCCSSSSSSSSCCSSSSSSSSSSSSSSSAASSCCTTSSSSSSSSSSSSSSSSCCCSAASSSSCCCMMMMBAAABAABBBBPPP
PPPTTTTTTTTTTMMMMMCCCCSSSSSCCCSSSSSSSSSSSSSSSAASSCCTTSSSSSSSSSSSSSSSSCCCCSSSSSCCCMMMMBBAAAAAABBBBPPP
PPPTTTTTTTTTTTMMMMMCCCCSSSCCCSSSSSSSSSSSSSSSSAASSCCSSSSSSSSSSSSSSSSSSSCCCCSSSCCMMMMMBBBBAAAABBBBBPPP
PPPTTTTTTTTTTTTTMMMCCCCCSSCCSSSSSSSSSSSSSSSSSAADSCCSSSSSSSSSSSSSSSSSSSSCCCCSCCCMMMMTBBBBBAAABBBBBPPP
PPPTTTTTTTTTTTTTTMMMMCCCCCCSSSSSSSSSSSSSSSSSSSSSSCCSSSSSSSSSSSSSSSSSSSSSCCCCCCMMMMTBBBBBBBAAABBBBPPP
PPPTTTTTTTTTTTTTTTMMMMCCCCCSSSSSSSSSSSSSSSSSSSSSSCCSSSSSSSSSSSSSSSSSSSSSSCCCCMMMMTTBBBBBBBBAAABBBPPP
PPPTTTTTTTTTTTTTTTTMMMMDCCCCSSSSSSSSSSSSSSSSSSSSSCCSSSSSSSSSSSSSSSSSSSSSCCCCDMMMTTTBBBBBBBBBAABBBPPP
PPPTTTTTTTTTTTTTTTTTMMDDCCCCCSSSSSSSSSSSSSSSSSSSSCCSSSSSSSSSSSSSSSSSSCCCCCCDDCMTTTBBBBBBBBBBAAAABPPP
PPPTTTTTTTTTTTTTTTTTMMCCDMCCCCCSSSSSSSSSSSSSSSSSSCCSSSSSSSSSSSSSSSCCCCCCMMMMCTTTBBBBBBBBBBBBBAAAAPPP
PPPTTTTTTTTTTTTTTTTTTTTCMMMCCCCCCCSSSSSSSSSSSSSSSCCSSSSSSSSSSSSSCCCCCCCMMMMMTTTTBTTBBBBBBBBBBBBAAPPP
PPPTTTTTTTTTTTTTTTTTTTTTMMMMMCCCCCCCCSSSSSSSSSXXSCCSSSSSSSSSSSCCCCCMMMMMMMTTTTTTTTTBBBBBBBBBBBBAAPPP
PPPTTTTTTTTTTTTTTTTTTTTTMMMMMMMCCCCCCCSSSSSSSSXXSCCSSSSSSSCCCCCCCCMMMMMMTTTTTBBTTBBBBBBBBBBBBBBBBPPP
PPPTTTTTTTTTTTTTTTTTTTTTTTTMMMMMMMMCCCCCCCCCCCCCCCCCCCCCCCCCCCCMMMMMMMMTTTTTTTTTTBTTBBBBBBBBBBBBBPPP
PPPTTTTTTTTTTTTTTTTTTTTTTTTTTMMMMMMMCCCCCCCCCCCCCCCCCCCCCCCCMMMMMMMMMTTTTTTTTTTTBBTTBBBBBBBBBBBBBPPP
PPPTTTTTTTTTTTTTTTTTTTTTTTTTTTTTMMMMMMMMMMMMCMMMMCCMMMMMMMMMMMMMMMTTTTTTTTTTTTBBTTTTBTTBBBBBBBBBBPPP
PPPTTTTTTTTTTTTTTTTTTTTTTTTTTTTTTTTMMMMMMMMMMMMMMMMMMMMMMMMMMMMTTTTTTTTTTTTTTTTTTTBBBTTBBBBBBBBBBPPP
PPPTTTTTTTTTTTTTTTTTTTTTTTTTTTTTTTTMMMMMMMMMMMMMMMMMMMMMMMMMTTTTTTTTTTTTTTTTTTTTTBTTTTBBTBBBBBBBBPPP
PPPTTTTTTTTTTTTTTTTTTTTTTTTTTTTTTTTTTTTTTTTTTMMMTMMTTTTTTTTTTTTTTTTTTTTTTTTTTTTTTTTTTBBTTTTTTBBBBPPP
PPPPPPPPPPPPPPPPPPPPPPPPPPPPPPPPPPPPPPPPPPPPPPPPPPPPPPPPPPPPPPPPPPPPPPPPPPPPPPPPPPPPPPPPPPPPPPPPPPPP
PPPPPPPPPPPPPPPPPPPPPPPPPPPPPPPPPPPPPPPPPPPPPPPPPPPPPPPPPPPPPPPPPPPPPPPPPPPPPPPPPPPPPPPPPPPPPPPPPPPP
PPPPPPPPPPPPPPPPPPPPPPPPPPPPPPPPPPPPPPPPPPPPPPPPPPPPPPPPPPPPPPPPPPPPPPPPPPPPPPPPPPPPPPPPPPPPPPPPPPPP
0000000000000000000000000000000000000000000000000000000000000000000000000000000000000000000000000000
0000000000000000000000000000000000000000000000000000000000000000000000000000000000000000000000000000
0000000000000000000000000000000000000000000000000000000000000000000000000000000000000000000000000000
0000000000000000000000000000000000000000000444444004444400000000000000000000000000000000000000000000
0000000000000000000000000000000000000000044444444004444440000000000000000000000000000000000000000000
0000000000000000000000000000000000444444444444444004444444444444000000000000000000000000000000000000
0000000000000000000000000000000000444444444000000000000444444444400000000000000000000000000000000000
0000000000000000000000000000000044444444440000000000000044444444444000000000000000000000000000000000
0000000000000000000000000000004444000000000000044004040000000000444444400000000000000000000000000000
0000000000000000000000000000044444000004044404444004040000000000044444440000000000000000000000000000
0000000000000000000000000004444400040404040004004004040014040010000004444400000000000000000000000000
0000000000000000000000004444444004440404040444004004440424040424000000444440000000000000000000000000
0000000000000000000000044444400004000404040000044004000434040434000000044444000000000000000000000000
0000000000000000000000444440000404044404444444444004440444040444044440000444400000000000000000000000
0000000000000000000044444400000404043400000004234004040400040000040004000044444000000000000000000000
0000000000000000000444440004440404042444444404124004040404440000040404000004444400000000000000000000
0000000000000000004444400004000404001400040204004004000404000000040404040000444440000000000000000000
0000000000000000044444000004440404440000040404044004444404440000040404044000044444000000000000000000
0000000000000000444400000000040412340000040404000000020420000000040400040000000444400000000000000000
0000000000000000444400044000044404440000040444400000040404440000040440440000000044440000000000000000
0000000000000004444000044400004412030000000000004000040400040000041400400000000004444000000000000000
0000000000000044440004444400000424040000044444444000040444040444442404000440000000444400000000000000
0000000000000444400004000400000434030000321400004000040004040000043444004404000000044440000000000000
0000000000004444000004040400000044040000040404444004344404044444044400044404400400004440000000000000
0000000000044440000004040400000044000000040404000004043404000004004400040400000400000444000000000000
0000000000044400000004040400000004440404440404000000002404444404444000440444440444400044400000000000
0000000000044400000000040440000000440304000400000000001400040404040004040000040300000004400000000000
0000000004444000444444440444000000040404044400000000000044040404000004040444044444040004440000000000
0000000004440004000400041234400000044404000400000000000000040004440044040400040004140004444000000000
0000000004440004040404040444400000000404040400000000000044444400400444040404044404244004444400000000
0000000044400000040414000400000000000400040400000000000000020000000404040404000004300400044400000000
0000000044000444440424444404400000000444440310000000000004440000000004044404444404440400004400000000
0000000444000432140234000004040400000040000320000000000004030000040004000004000404040000004444000000
0000004400000444044444444404040440000044044400000000000002044000044424444444440404044444004444000000
0000004400040000000000040004000400000000044000000000000004000000440004000000040400040044000400000000
0000004400444400000444040444440400000000004444000000000434040044440404440444040444040444000000000000
0000000000444400000000340000340300400000004400040000000004400032000400000404000300000400000000000000
0000000000000444444444042444044444030000004404044004444444400444100444444404443400004400000004440000
0000040000000000440400040004000400044000000444004004000000000432042300000400000400000000000004440000
0000444000000000044404044400000004300400000044044004440440044444441400000004444400000004444004440000
0000440004444400000444440000000004040400000004004004041440000404002400000000000000000004000004440000
0000440004044444440000440000000000004440000004444004042400444404040000000000000004444444044004440000
0000440000042004044000000000000000400044000000444004003404040000440000000000000440000004030004440000
0000440044440404044444000000000000444004400000004004004044040440000000000000044444404444044004440000
0000440000040400000004000000000000004411240000000000000000040400000000000000123400000000040004440000
0000440004040444444404400000000000004444234000000000000004044004444000000000044404444444440004440000
0000440004000400040004000000000000000004444001111111111004400044400000000000000400040004030004440000
0000440044444444040444440000000004000000000001222222221000004444440400000000440444040444044004444000
0000440004000000040432100000000004004444000001233333321000440000040400000004040004040403000004444000
0004440004040444040444044444000404044444400001234444321000040444040444044424044404040404000004444000
0004440004040400040000041004000034000123440001234554321000041234040004040004000402040403000000444000
0004440044040444444444442404040404400123440001234554321000044444044440040444040444440444000004440000
0004440000040000000000243404043024004444000001234444321000000444040000040434040004000003000004440000
0004440004444444444000044404040044440000000001233333321000000004040404440424040404444404000004440000
0000440004000012340000000004000040000000000001222222221000000000044424321410040400000403000004440000
0000440044044404440000000444000000000000444001111111111000000000000004440000441404440404444004440000
0000440004123404000000000444000000000004123400000000000000000400000000000000432404000400040004440000
0000440004044404044444444000000000000034044000000000000000000444440000000000441404044404440004440000
0000440000040004444440000000004440000400044000004004000000044400044000000000000044440004000004400000
0000040004400444400000000004440440044404040004004004400000043214040244440000000000444444040004400000
0000044004004400000000004440000404040004040044404004444400044404000000044444400000000444440044400000
0000044000404000000004440404044404040404000444444004000040004444400400040040444400000000000044400000
0000044000000000044044000404000400204440000410004004000040000000404444000030000444400000000044400000
0000044400000044444000440404440404000000004424044004404404000000000044440444044444444400000444000000
0000044400044444000000000400040030000000004434044004000400000000000040000004000000040444400444000000
0000004400444404040444444444040400000000004444044004044444000000000044044404400000040434000440000000
0000004400043404040004000000043000000000000400044004000004000000000004000404000000040424000440000000
0000044400042404444404044444440400000000002000000000000123000000000004444404400000040410004440000000
0000044400041004001004000024000400000000000410000004040004000000000004000410000000000400004440000000
0000004440000444044444000004440400000000000424000004040444000000000044440424044424444400044400000000
0000004444000404300000000000340400000000000434000004040004000000000000000434000404000000044400000000
0000000444000404044444400044040400000000000444000004444444400000000404444444040404440000444000000000
0000000044400000040000000000040000000000003000000004040000040000000400000004040400000000440000000000
0000000004440044440444000004444400440004444444400004040404444444400044444434440444400004440000000000
0000000000440000000400040400000400400420000000004004040404000000440004000000000400000004400000000000
0000000000444000444404440440044004044444444444444004040404044444440000000004441400000444400000000000
0000000000444400030004003410440044000004000004004004040400000000044000440004232400000444000000000000
0000000000044440004444040424400044404404444404044000044400000444444400044004144400004440000000000000
0000000000004440000400040434400440000400000004004000040000040400000400004004040000004400000000000000
0000000000000444000044040444004404044444444400044000040444044404444440004004040000444400000000000000
0000000000000444440000040440004004042000000400044000040404000004000440000444000004444000000000000000
0000000000000044444000040400044404440444440400044004040404444444040444000044000444440000000000000000
0000000000000000444000004400443400000000040400004004000000000400040404400000000444400000000000000000
0000000000000000044440000004442404444444440404044004444444440404440404440000004444000000000000000000
0000000000000000004444000004001404000401230404004004000004040402340004040000044440000000000000000000
0000000000000000000444400000044404440404440404444004444404040444244404000000044400000000000000000000
0000000000000000000044000000040004000400040400044004321404020400140400000000004000000000000000000000
0000000000000000000044000400000444044444040444044004440404044404440000004444000000000000000000000000
0000000000000000000000004440000000040000040404004004000404000004000000044444000000000000000000000000
0000000000000000000000004444400000000444440404004004044404444000000444444400000000000000000000000000
0000000000000000000000004444444000000000040000004004000400000000004444440000000000000000000000000000
0000000000000000000000000004444444400000000000000000000000000004444444400000000000000000000000000000
0000000000000000000000000000044444440000000000000000000000004444444440000000000000000000000000000000
0000000000000000000000000000000044444444444404444004444444444444440000000000000000000000000000000000
0000000000000000000000000000000000044444444444444444444444444440000000000000000000000000000000000000
0000000000000000000000000000000000044444444444444444444444440000000000000000000000000000000000000000
0000000000000000000000000000000000000000000004440440000000000000000000000000000000000000000000000000
0000000000000000000000000000000000000000000000000000000000000000000000000000000000000000000000000000
0000000000000000000000000000000000000000000000000000000000000000000000000000000000000000000000000000
0000000000000000000000000000000000000000000000000000000000000000000000000000000000000000000000000000
