30
30
PPPPPPPPPPPPPPPPPPPPPPPPPPPPPP
PPPPPPPPPPPPPPPPPPPPPPPPPPPPPP
PPPPPPPPPPPPPPPPPPPPPPPPPPPPPP
PPPMMMMMMMMMMMMMMMMMMMMMMMMPPP
PPPMXCCCCCCCCCCCCCCCCCCCCXMPPP
PPPMSMMMMMMMMMSMMMMMMMMMMSMPPP
PPPMSMMTTTMMMAATMMMMCCCMMSMPPP
PPPMSMMTDTSSSACTSSSSCXCMMSMPPP
PPPMSMMTTTMMMATTMMMMCCCMMSMPPP
PPPMSMBMMMMCMMCMMCCMMMMSMSMPPP
PPPMSMBMCCCMCMCCCMMCCCMSMSMPPP
PPPMSMBMCMMMCMMMMMMMMCMSMSMPPP
PPPMTMBMCCCMMCCCCCCCCCMSMTMPPP
PPPMTMBMMMMCMMMMMMMMMMMSMTMPPP
PPPMTMBMAAMMCMCMCMMMAAMSMTMPPP
PPPMTMBMAAMMMCMCMCMMAAMSMTMPPP
PPPMTMBMMMMMMMMMMMCMMMMSMTMPPP
PPPMTMBMCCCCCCCCCMMCCCMSMTMPPP
PPPMSMBMCMMMMMMMMCMMMCMSMSMPPP
PPPMSMBMCCCMMCCCMCMCCCMSMSMPPP
PPPMSMBMMMMCCMMCMMCMMMMSMSMPPP
PPPMSMMCCCMMMMTTAMMMTTTMMSMPPP
PPPMSMMCXCSSSSTCASSSTDTMMSMPPP
PPPMSMMCCCMMMMTAAMMMTTTMMSMPPP
PPPMSMMMMMMMMMMSMMMMMMMMMSMPPP
PPPMXCCCCCCCCCCCCCCCCCCCCXMPPP
PPPMMMMMMMMMMMMMMMMMMMMMMMMPPP
PPPPPPPPPPPPPPPPPPPPPPPPPPPPPP
PPPPPPPPPPPPPPPPPPPPPPPPPPPPPP
PPPPPPPPPPPPPPPPPPPPPPPPPPPPPP
000000000000000000000000000000
000000000000000000000000000000
000000000000000000000000000000
000555555555555555555555555000
000533333333333333333333335000
000535555555553555555555535000
000535555555533355551115535000
000535555544433322221115535000
000535555555533355551115535000
000535455553553553355553535000
000535453335353335533353535000
000535453555355555555353535000
000535453335533333333353535000
000535355553555555555553535000
000535350055353535550053535000
000535350055535353550053535000
000535355555555555355553535000
000535253333333335533353535000
000535253555555553555353535000
000535253335533353533353535000
000535255553355355355553535000
000535511155553335555555535000
000535511122223334445555535000
000535511155553335555555535000
000535555555555355555555535000
000533333333333333333333335000
000555555555555555555555555000
000000000000000000000000000000
000000000000000000000000000000
000000000000000000000000000000
